00000000000000000000000000000000000000000000000000
00100300100100100100300100100100100100300100100100
00000000000000000000000000000000000000000000000000
10010020010010010010010010010010010010010010010010
00000000000000000000000000000000000000000000000000
01003001001001001001001001001001003001001001001001
00000000000000000000000000000000000000000000000000
00100100300100100100100100100300100100100100300100
00000000000000000000000000000000000000000000000000
00000000000000000000000000000000000000000000000000
00000000000000000000000000000000000000000000000000
00000000000000000000000000000000000000000000000000
00000000000000000000000000000000000000000000000000
00000000000000000000000000000000000000000000000000
00000000000000000000000000000000000000000000000000