10000000000010000000000020000000000010000000000010
01000000000101000000000101000000000101000000000100
00100000001000100000001000100000001000100000001000
00030000030000030000030000030000030000030000030000
00001000100000001000100000001000100000001000100000
00000101000000000101000000000101000000000101000000
00000010000000000010000000000010000000000010000000
00000000000000000000000000000000000000000000000000
00000000000000000000000000000000000000000000000000
00000000000000000000000000000000000000000000000000
00000000000000000000000000000000000000000000000000
00000000000000000000000000000000000000000000000000
00000000000000000000000000000000000000000000000000
00000000000000000000000000000000000000000000000000
00000000000000000000000000000000000000000000000000