00000000000000000000000000000000000000000000000000
01113111131111311113111113111131111311113111131110
01000000000000000000000000000000000000000000000010
02113111131111311113111113111131111311113111130010
01000000000000000000000000000000000000000000000010
01001131111311113111131111131111311113111131111310
01000000000000000000000000000000000000000000000010
01113111131111311113111113111131111311113111130010
00000000000000000000000000000000000000000000000000
00000000000000000000000000000000000000000000000000
00000000000000000000000000000000000000000000000000
00000000000000000000000000000000000000000000000000
00000000000000000000000000000000000000000000000000
00000000000000000000000000000000000000000000000000
00000000000000000000000000000000000000000000000000