00000000000000000000000000000000000000000000000000
01113111131111311113111113111131111311113111131110
03000000000000000000000000000000000000000000000030
01000111131111311113111113111131111311113111100010
03000300000000000000000020000000000000000000300030
01000111131111311113111113111131111311113111100010
03000000000000000000000000000000000000000000000030
01113111131111311113111113111131111311113111131110
00000000000000000000000000000000000000000000000000
00000000000000000000000000000000000000000000000000
00000000000000000000000000000000000000000000000000
00000000000000000000000000000000000000000000000000
00000000000000000000000000000000000000000000000000
00000000000000000000000000000000000000000000000000
00000000000000000000000000000000000000000000000000