00000000000000000000000000000000000000000000000000
01113111131111311113111113111131111311113111131110
01000000000000000000000000000000000000000000000010
03000011000011000011000011000011000011000011000030
01000000000000000000000000000000000000000000000010
03011000011000011000011000011000011000011000012030
01000000000000000000000000000000000000000000000010
01113111131111311113111113111131111311113111131110
00000000000000000000000000000000000000000000000000
00000000000000000000000000000000000000000000000000
00000000000000000000000000000000000000000000000000
00000000000000000000000000000000000000000000000000
00000000000000000000000000000000000000000000000000
00000000000000000000000000000000000000000000000000
00000000000000000000000000000000000000000000000000